1111111111111111111111111111111111
1E00000000000000000010001C00000001
1110010100100000101011100100010101
1100010010101010001001000000010101
1000000000000P00000000000000000001
1111111111111111111111111111111111